1131112231
1        5
1  1123  4
3  2  1  1
4        3
132121   1
1        1
2  1 13211
2  2     1
1411333531