1122222221
1        2
1        2
2        1
1        2
1        1
133333 333
1        3
1        3
1555555551