1131112231
1        5
1        4
3        1
4        3
1        1
1        1
2        1
2        1
1411333531