6676776766
6        7
7        6
7        7
666      6
7        7
6     6666
7        7
6        6
6676676766